#####################
S   #       #   # # #
###  #### # # # # # #
# #   # # # # #     #
# # ### ##### # #####
#   # #   # #     # #
# ### # ### ### ### #
#       # # #     # #
# ##### # # # # # # #
#     #     # # #   #
# ### ### ##### # ###
#   #   # #     #   #
### ##### # #########
#     # # #   #     #
# ### # # # # # #####
#   # # #   # #   # #
### ### # # ### ### #
#     # # #       # #
# ##### ### # # # # #
#       #   # # #   #
###################F#