###############################
S     #           #     #  #  #
####  #######  #  ####  #  #  #
#  #     #  #  #     #        #
#  #  ####  #######  #  #######
#     #  #     #  #        #  #
#  ####  #  ####  ####  ####  #
#           #  #  #        #  #
#  #######  #  #  #  #  #  #  #
#        #        #  #  #     #
#  ####  ####  #######  #  ####
#     #     #  #        #     #
####  #######  #  #############
#        #  #  #     #        #
#  ####  #  #  #  #  #  #######
#     #  #  #     #  #     #  #
####  ####  #  #  ####  ####  #
#        #  #  #           #  #
#  #######  ####  #  #  #  #  #
#           #     #  #  #     #
#############################F#